15														
15														
														
-1	-1	-1	-1	-1	-1	-1	-1	-1	-1	-1	-1	-1	-1	-1
-1	-4	-4	-4	-1	-1	-5	-5	-5	-1	-1	-6	-6	-6	-1
-1	-4	-4	-4	-1	-1	-5	-5	-5	-1	-1	-6	-6	-6	-1
-1	-4	-4	-4	-1	-1	-5	-5	-5	-1	-1	-6	-6	-6	-1
-1	-1	-1	-1	-1	-1	-1	-1	-1	-1	-1	-1	-1	-1	-1
-1	-1	-1	-1	-1	-1	-1	-1	-1	-1	-1	-1	-1	-1	-1
-1	-3	-3	-3	-1	-1	0	0	0	-1	-1	-7	-7	-7	-1
-1	-3	-3	-3	-1	-1	0	0	0	-1	-1	-7	-7	-7	-1
-1	-3	-3	-3	-1	-1	0	0	0	-1	-1	-7	-7	-7	-1
-1	-1	-1	-1	-1	-1	-1	-1	-1	-1	-1	-1	-1	-1	-1
-1	-1	-1	-1	-1	-1	-1	-1	-1	-1	-1	-1	-1	-1	-1
-1	-2	-2	-2	-1	-1	1	1	1	-1	-1	8	8	8	-1
-1	-2	-2	-2	-1	-1	1	1	1	-1	-1	8	8	8	-1
-1	-2	-2	-2	-1	-1	1	1	1	-1	-1	8	8	8	-1
-1	-1	-1	-1	-1	-1	-1	-1	-1	-1	-1	-1	-1	-1	-1
